==================================================================
=                                                                =
=                                                                =
=                                                                =
=                                                                =
=                                                                =
=                                                                =
=                                                                =
=                                                                =
=                                                                =
=                                                                =
=                                                                =
=                                                                =
=      *                                                         =
=  >>>>>>>>>>>                                                   =
=                                                                =
=                                                                =
=                      ==================                        =
=                                                                =
=                                                                =
=                                                                =
=                                                                =
=                                                                =
=                                                                =
=                                                                =
=                      ==================                        =
=                                                                =
=                                                                =
=                                                                =
=                                                                =
=                                                                =
=                                                                =
=                                                                =
=                                                                =
=                                                                =
=                                                                =
=                                                                =
=                                                                =
=                                                                =
=                                                                =
=                                                                =
=                                                                =
=                                                                =
==================================================================
