==================================================================
=                                                                =
=                                                                =
=                                                                =
=                                                                =
=                                                                =
=                                                                =
=                                                                =
=                                                                =
=                                                                =
=                                                                =
=                                                                =
=                                                                =
=      *     <                                                   =
=  >>>>>>>>>>^                                                   =
=                                                                =
=                                                                =
=                      ==================                        =
=                                                                =
=                                                                =
=                                                                =
=                                                                =
=                                                                =
=                                                                =
=                                                                =
=                      ==================                        =
=                                                                =
=                                                                =
=                                                                =
=                                                                =
=                                                                =
=                                                                =
=                                                                =
=                                                                =
=                                                                =
=                                                                =
=                                                                =
=                                                                =
=                                                                =
=                                                                =
=                                                                =
=                                                                =
=                                                                =
==================================================================
