=====================================
=                                   =
=                                   =
=                ============       =
=                        *          =
=                                   =
=  >>>>>         ============       =
=                                   =
=                                   =
=                ============       =
=                                   =
=                                   =
=====================================
