=============
= >>>>>>>>v =
=     <<<<< =
=     ====  =
=           =
=        *  =
=           =
=           =
=     ====  =
=           =
=           =
=           =
=============
