=====================
=                   =
=                   =
=                   =
=                   =
=                   =
=                   =
=                   =
=                   =
=                   =
= >>>        *      =
=                   =
=                   =
=                   =
=                   =
=                   =
=                   =
=                   =
=                   =
=                   =
=====================
